1111111111111111111111111
1P00000000000010000000001
1011111111111010111111101
1010000000001010100000101
1010111111101010101110101
1010100000101010101C10101
1010101110101010101010101
1010101C10101010101010101
1010101010101010101010101
1010101010100000101010101
1010101010111110101010101
1000001010000000101010101
1111101011111111101010101
1000001000000000001010001
1011111111111111111011101
100000000000C000000000001
1011111111111111111111101
1010000000000000000000101
1010111111111111111110101
10100000000C0000000010101
1011111111111111111010101
1000000000000000000010101
1111111111111111111110101
1E00000000000000000000001
1111111111111111111111111